XXXXXXXXXXXXXXXXXXXXXXXXXXXXXXX
XXXD XX D      XXXXX     DDDXXX
XDXX X  XX        DX   XXXXDDXX
X    X  XX     D XXX     DXXXXX
X    5       XXXXXX           X
X    D               5        X
XXXXXXXXXXXXXXXXXXXXXXXXXXXXXXX