XXXXXXXXXXXXXXXXXX
XXXD XX D   XXXXXX
XDXX X  XX  XXXXXX
X    X  XX  DXXXXX
X R  1           X
XXXXXXDXXXXXXXXXXX
XXXXXXXXXXXXXXXXXX