XXXXXXXXXXXXXXXXXX
XXXD XX D   XXX XX
XDXX XD     XXD XX
X      X    DDX XX
X            D   X
XD  DXDX XXX     X
XXXXXXXXDXXXXXXXXX
